Sevice Name, Count, Start Time, End Time, C, T, D
Seq, 1, 1000, 1000, 0, 1000, 2000
Seq, 2, 2000, 2000, 0, 1000, 3000
Seq, 3, 3000, 3000, 0, 1000, 4000
Seq, 4, 4000, 4000, 0, 1000, 5000
Seq, 5, 5000, 5000, 0, 1000, 6000
Seq, 6, 6000, 6000, 0, 1000, 7000
Seq, 7, 7000, 7000, 0, 1000, 8000
Seq, 8, 8000, 8000, 0, 1000, 9000
Seq, 9, 9000, 9000, 0, 1000, 10000
Seq, 10, 10000, 10000, 0, 1000, 11000
S1, 1, 1000, 1681, 681, 1000, 2000
S1, 2, 2000, 2464, 464, 1000, 3000
S1, 3, 3000, 3458, 458, 1000, 4000
S1, 4, 4000, 4463, 463, 1000, 5000
S1, 5, 5000, 5453, 453, 1000, 6000
S1, 6, 6000, 6456, 456, 1000, 7000
S1, 7, 7000, 7465, 465, 1000, 8000
S1, 8, 8000, 8467, 467, 1000, 9000
S1, 9, 9000, 9457, 457, 1000, 10000
S1, 10, 10000, 10459, 459, 1000, 11000
S2, 1, 1000, 1031, 31, 1000, 2000
S2, 2, 2000, 2027, 27, 1000, 3000
S2, 3, 3000, 3029, 29, 1000, 4000
S2, 4, 4000, 4036, 36, 1000, 5000
S2, 5, 5000, 5029, 29, 1000, 6000
S2, 6, 6000, 6033, 33, 1000, 7000
S2, 7, 7000, 7035, 35, 1000, 8000
S2, 8, 8000, 8035, 35, 1000, 9000
S2, 9, 9000, 9036, 36, 1000, 10000
S2, 10, 10000, 10022, 22, 1000, 11000
S3, 1, 1000, 1034, 34, 1000, 2000
S3, 2, 2000, 2026, 26, 1000, 3000
S3, 3, 3000, 3029, 29, 1000, 4000
S3, 4, 4000, 4036, 36, 1000, 5000
S3, 5, 5000, 5029, 29, 1000, 6000
S3, 6, 6000, 6033, 33, 1000, 7000
S3, 7, 7000, 7035, 35, 1000, 8000
S3, 8, 8000, 8035, 35, 1000, 9000
S3, 9, 9000, 9036, 36, 1000, 10000
S3, 10, 10000, 10024, 24, 1000, 11000
